11111
1OOP1
1OCO1
1OOO1
1OEO1
11111
